16 16
100 100
1 1 1 1 1 1 1 1 1 1 1 1 1 1 1 1 
1 9 9 9 9 9 9 9 9 9 9 9 9 9 9 1
1 9 9 9 4 4 4 4 4 4 4 4 9 9 9 1
1 9 9 9 4 6 6 6 6 6 6 4 9 9 9 1
1 9 9 9 4 6 6 6 6 6 6 4 9 9 9 1
1 9 9 3 4 6 6 6 6 6 6 4 9 9 9 1
1 9 3 3 4 4 4 2 2 4 4 4 9 9 9 1
1 9 3 10 7 10 8 8 8 8 8 8 9 9 9 1
1 9 3 7 10 7 8 8 8 8 8 8 9 9 9 1
1 9 3 10 7 10 3 9 9 9 9 9 9 9 3 1
1 9 3 7 10 3 3 9 9 9 9 9 9 9 3 1
1 9 3 10 7 3 3 9 9 9 9 9 9 9 3 1
1 9 9 9 9 9 9 9 9 9 9 9 9 9 3 1
1 9 9 9 9 9 9 9 9 9 9 9 9 9 3 1
1 9 9 9 9 9 9 9 9 9 9 9 9 9 3 1
1 1 1 1 1 1 1 1 1 1 1 1 1 1 1 1
