16 16
100 100
1 1 1 1 1 1 1 1 1 1 1 1 1 1 1 1 
4 6 6 6 6 6 6 6 6 6 6 6 1 2 6 1
4 6 6 6 6 6 6 6 6 6 6 6 1 2 6 1
4 6 6 6 6 6 6 6 6 6 6 6 1 2 6 1
4 6 6 6 6 6 6 6 6 6 6 6 6 6 6 1
4 6 6 6 6 6 8 8 8 8 6 6 6 6 6 1
4 6 6 6 6 2 2 8 8 8 6 6 6 6 6 1
4 6 6 7 7 7 7 8 8 8 6 6 6 6 6 1
4 6 6 7 7 7 7 8 8 8 6 6 6 6 6 1
4 9 9 7 7 7 7 9 9 9 9 9 9 9 3 1
4 9 9 5 5 5 5 9 9 9 9 9 9 9 3 1
4 9 9 5 5 5 5 9 9 9 9 9 9 9 3 1
4 9 9 5 5 5 5 9 9 9 9 9 9 9 3 1
4 9 9 5 5 5 5 9 0 0 0 9 9 9 3 1
4 9 9 5 5 5 5 9 9 9 9 9 9 9 3 1
4 4 4 4 4 4 1 1 1 1 1 1 1 1 1 1 